date,sha,text,data,bss,total
2022-01-10 23:04:44.309131,c53927869b2ce15345c6c1751164ca6e4aa47c02,22599,1464,24,24087
2022-01-10 23:10:04.748906,3aab209ca2654013356ba96cd1480ec4b0b76010,22599,1464,24,24087
2022-01-11 09:32:16.986632,b252173284b23744a78d9a599106e75297b9ff81,22599,1464,24,24087
2022-01-11 14:59:16.261895,e2eed0b46142015e972cfd301d0e514eb0cf131e,22599,1464,24,24087
2022-01-11 15:03:24.298672,e2eed0b46142015e972cfd301d0e514eb0cf131e,22599,1464,24,24087
2022-01-31 18:28:47.436516,746f880a405aeca2db6d005fd9fb8e451f3cea34,23756,1600,24,25380
2022-02-04 13:02:56.187989,6588458690c5cddc9148ae63bde8beef70055d47,23748,1600,24,25372
2022-02-07 13:10:21.497565,9cd34d1753fd49f374d1a076f6284179f301b338,23748,1600,24,25372
2022-02-11 13:04:50.531123,6f8fb4934a1693a1661629534ed4b9f62cb50da3,23748,1600,24,25372
2022-02-14 13:10:36.573550,041371735a655b24c5e9447422e2115a672ab0a6,23768,1600,24,25392
2022-02-16 13:09:29.771280,9efa395baa7d85db5807202b3420550300d9297d,23768,1600,24,25392
2022-02-18 13:05:31.023686,c9b21d3a39842c32bb1f075ddbf3599d3c6b5c3f,23768,1600,24,25392
2022-02-28 13:08:45.304161,1a0287fc5fa81fa6aa1dcfb0c5b2e01f74164393,23768,1600,24,25392
2022-03-01 13:09:24.718558,f3c22690fc34183e8f1c068ce8a8d98b5b729cc8,23768,1600,24,25392
2022-03-04 13:07:15.732929,e8df576b38990f852396c0bc91db26ddcccddc3a,25712,1600,24,27336
2022-03-07 13:12:18.397213,d7f89e4167e69d219725520e56f1123aa095753d,25712,1600,24,27336
2022-03-08 13:12:14.032618,cd15c14017bcb33d1ed55ee27c5fab63eef74ad6,25712,1600,24,27336
2022-03-09 13:11:42.347889,63df59cb461fdec28cc4377cf83097217aeb5b2c,26232,1648,24,27904
2022-03-10 13:12:39.360738,180694427a7c92530083514bdd0a36a9b7a3f24c,26232,1648,24,27904
2022-03-14 13:11:31.163719,0b6c93a99f4a79ad8c29ac306da1ac8307a3281e,26232,1648,24,27904
2022-03-15 13:12:17.005930,7cb4b832abdf33490154d8cf7afe0625b133b3e9,26232,1648,24,27904
2022-03-16 13:12:13.875189,afd41a759acc425654fb71ce697c03656ac11be9,26232,1648,24,27904
2022-03-17 13:08:07.891376,359c83a84fed0cb164774ff36798e52d2004eec8,26280,1648,24,27952
2022-03-18 13:12:04.777824,89a783b8d5d6788527f6cba296a5862072a3831a,26280,1648,24,27952
2022-03-21 13:12:30.543076,ea94f768500540d816a81d93cb1d1c868dbdfadd,26280,1648,24,27952
2022-03-23 13:13:22.876874,e0d6c42f5c410f8e1a2aba8ddd0f74c664f68a4f,26280,1648,24,27952
2022-03-25 13:23:49.881217,af1e85e691e9077529644056a62e569a30f03df6,26280,1648,24,27952
2022-03-28 13:13:58.898980,5d514fc8d751547b3ee4e595331c7e6f24e2fdb3,26280,1648,24,27952
2022-03-29 13:14:12.002745,1a0c74232ef6ec6f513e9026e3c47e46089ccb88,26280,1648,24,27952
2022-03-30 13:09:22.501165,23ba60887693bbc64a60e6b13d9b1aca44b6d06c,26280,1648,24,27952
2022-03-31 13:15:21.304715,c532687e2d238f1f18be0a776f216ede476263f4,26280,1648,24,27952
2022-04-01 13:18:33.288778,2225fc7d5dad0f22e25fcf21c1a1f9f1a2c143fe,26280,1648,24,27952
2022-04-04 13:13:19.092000,b92f00f8dee2ff51209d82a29f67cc18f625a12f,26280,1648,24,27952
2022-04-05 13:13:27.878391,d6eb8ce1a5cb4faafda2db153a0f2661a9a2871a,26280,1648,24,27952
2022-04-06 13:16:18.362975,b0fd265b9b808db0c3bf51b6cd1d6e94ecf903cb,27112,1808,24,28944
2022-04-07 13:14:16.648236,1501b574b74fd7877aba30aa9d8b667f41b139c3,27128,1808,24,28960
2022-04-10 13:07:08.371449,a56087ffa2703b4d5632f024a8a4c899815c31bb,27128,1808,24,28960
2022-04-11 13:15:47.681219,f3a194bf6af9022300845d51e1d7faec76b2dce2,27128,1808,24,28960
2022-04-12 13:16:28.344431,79fa421f21e16791a1354ba7b2b7022300309e54,27240,1816,24,29080
2022-04-13 13:15:24.742545,9676529ecd3ed139395953d7b4110dd08a0b696c,27240,1816,24,29080
2022-04-14 13:16:39.708327,d1a2e3db4683ce3bd1e6db9012214a7cdc254ecf,27240,1816,24,29080
2022-04-15 13:08:22.417975,0875b72ea245ad092bdf7212940d1d885cadb535,27240,1816,24,29080
2022-04-16 13:07:45.912488,77f45ff83abffe0ef658999302d63cbb47672456,27240,1816,24,29080
2022-04-17 13:07:39.908345,4969e4766af6a3a9b1c0e6e0994484156de57d41,27240,1816,24,29080
2022-04-18 13:10:19.534674,cb3ca81536d6886c0d6aeea3c158ba2e549050e7,27240,1816,24,29080
2022-04-19 13:20:36.048149,78bb847ed8fe1451b016948169198d787749e8f4,27560,1816,24,29400
2022-04-20 13:15:02.022220,863ab9a3f588f7e9f38ed078778f32a3a2658181,27560,1816,24,29400
2022-04-21 13:13:26.364513,842768675cbfd256b7be36fb415df4f8a6439f6a,27560,1816,24,29400
2022-04-22 13:20:00.011409,a94415963814abfb46d2c1533a6d9f48c1059a2a,27560,1816,24,29400
2022-04-25 13:18:30.533687,448828bd9cab0df892bfb103b98b7725d12d15ae,27560,1816,24,29400
2022-04-26 13:20:11.283534,1bdc373d4dfa1ec0a7275c5cd5e5138fffd0bb3f,27560,1816,24,29400
2022-04-27 13:18:30.924296,abe4c247d118dd1df16dd52ee784b925129dc38c,27648,1824,24,29496
2022-04-28 13:20:36.843062,a2e4fe943a1f594df9dbf41cd6940ddd17fca4aa,27632,1824,24,29480
2022-04-29 13:19:20.420802,33362da8ac2b661705c6e3582440ec325059b941,27632,1824,24,29480
2022-05-02 13:17:46.865473,10b1223343303b45e6f62a433e25efb5f87958d7,27632,1824,24,29480
2022-05-03 13:17:51.546660,9c279d09de74e0c6b3cb3d215107617767f3a5dc,27632,1824,24,29480
2022-05-05 13:17:34.083422,d135616c5c594f9b2046ae27a49955a497ee46de,27632,1824,24,29480
2022-05-06 13:13:46.156142,d0f135272d0c49dbdd879630be80445fe3617bda,27632,1824,24,29480
2022-05-09 13:14:33.299290,500cf89de4133c08b7099c668887d390bf315fc7,27632,1824,24,29480
2022-05-10 13:18:26.793451,ad60ac4822c4006dc97001abf31881f046b113ea,27632,1824,24,29480
2022-05-11 13:16:04.045831,02f0d05f5f84ee5eb27b9a312470cb02d48f7c1a,27632,1824,24,29480
2022-05-13 13:23:16.868101,e211ce56c936eeb5d3d02f95c37de892a60c84e3,27644,1824,24,29492
2022-05-17 13:14:28.837618,60b78ee5fd9be43c72c8a5f665ec0526f6e75cb2,27644,1824,24,29492
2022-05-24 13:15:50.940698,07821fd35e8aaca66855fa07b402325be3b70398,27644,1824,24,29492
2022-05-25 13:15:46.804226,02715237c1fc0a23f465226364d206277f54ebce,27644,1824,24,29492
2022-05-26 02:21:37.044418,ca1d69993f612433e9f4f788e494389d9e7378c1,27644,1824,24,29492
2022-05-26 02:27:44.332608,ca1d69993f612433e9f4f788e494389d9e7378c1,27644,1824,24,29492
2022-05-26 13:14:45.192989,ca1d69993f612433e9f4f788e494389d9e7378c1,27644,1824,24,29492
2022-05-27 13:15:25.001568,ca1d69993f612433e9f4f788e494389d9e7378c1,27644,1824,24,29492
2022-05-28 13:09:48.335406,7d48cbd96c7fc657b5aa0b39a6e9a238b82d2ee7,27644,1824,24,29492
2022-05-29 13:10:11.693685,7d48cbd96c7fc657b5aa0b39a6e9a238b82d2ee7,27644,1824,24,29492
2022-05-30 13:16:31.114763,7d48cbd96c7fc657b5aa0b39a6e9a238b82d2ee7,27644,1824,24,29492
2022-05-31 13:15:46.949781,7d48cbd96c7fc657b5aa0b39a6e9a238b82d2ee7,27644,1824,24,29492
2022-06-01 13:17:52.489317,8a1cbc99e8905c83d66530d2fa340668d602ed01,27644,1824,24,29492
2022-06-02 13:17:59.560301,8a1cbc99e8905c83d66530d2fa340668d602ed01,27628,1824,24,29476
2022-06-03 13:13:34.986864,40800f770d5bbba64e100636bc1f1bed4f0dfa65,27628,1824,24,29476
2022-06-04 13:07:02.676520,90d62ab628a256fd37d810173e81533e6d51d94b,27628,1824,24,29476
2022-06-05 13:07:32.407047,90d62ab628a256fd37d810173e81533e6d51d94b,27628,1824,24,29476
2022-06-06 13:15:16.843072,90d62ab628a256fd37d810173e81533e6d51d94b,27628,1824,24,29476
2022-06-07 13:14:46.669671,da99cf182c442d5fa0cabf25abaf93b4d9b64841,27628,1824,24,29476
2022-06-08 13:14:15.621051,87fb33bed5fb5297d3944abf67dfb3f85b657dd1,27628,1824,24,29476
2022-06-09 13:15:36.793081,6ab99123f450dcb15e80df7b42601ad6f160f3ec,27628,1824,24,29476
2022-06-10 13:14:27.899214,6ab99123f450dcb15e80df7b42601ad6f160f3ec,27628,1824,24,29476
2022-06-11 13:08:12.904238,f868a900f1f788fd0a55b5655b47fc352f9a0239,27628,1824,24,29476
2022-06-12 13:07:16.873457,f868a900f1f788fd0a55b5655b47fc352f9a0239,27628,1824,24,29476
2022-06-13 13:15:26.057174,f868a900f1f788fd0a55b5655b47fc352f9a0239,27628,1824,24,29476
2022-06-14 05:21:59.503421,f868a900f1f788fd0a55b5655b47fc352f9a0239,27628,1824,24,29476
2022-06-14 07:01:59.431699,b01a8591677e3ce4ac75fc365be11352d41357f5,27628,1824,24,29476
2022-06-14 07:11:55.537560,7dc244b3e26a85afeaab7983d3fede26b6eba7bc,27628,1824,24,29476
2022-06-14 07:30:02.787271,584154a89fa555b2f59699262dc74e08df18ad41,27628,1824,24,29476
2022-06-14 07:58:11.792388,658174a11d2dd98afaca8101a744fd2649d2e3fb,27628,1824,24,29476
2022-06-14 13:13:49.685111,658174a11d2dd98afaca8101a744fd2649d2e3fb,27628,1824,24,29476
2022-06-15 13:16:25.501504,634aeefc7cad06b784a6e28aa511073a39bf0093,27628,1824,24,29476
2022-06-16 13:15:18.070078,634aeefc7cad06b784a6e28aa511073a39bf0093,27628,1824,24,29476
2022-06-17 13:12:28.880840,634aeefc7cad06b784a6e28aa511073a39bf0093,27628,1824,24,29476
2022-06-18 13:08:12.643283,3d40b1241a3af4ede38493b6079c17a0b1c10ca9,27628,1824,24,29476
2022-06-19 13:07:41.507502,3d40b1241a3af4ede38493b6079c17a0b1c10ca9,27628,1824,24,29476
2022-06-20 13:16:14.938646,3d40b1241a3af4ede38493b6079c17a0b1c10ca9,27628,1824,24,29476
2022-06-21 13:16:34.584187,b4b0c56be11a184a450c74c218bbb0b9d4661816,27628,1824,24,29476
2022-06-22 13:16:11.214675,b4b0c56be11a184a450c74c218bbb0b9d4661816,27628,1824,24,29476
2022-06-23 13:15:02.332238,b4b0c56be11a184a450c74c218bbb0b9d4661816,27628,1824,24,29476
2022-06-24 13:16:40.236538,b4b0c56be11a184a450c74c218bbb0b9d4661816,27628,1824,24,29476
2022-06-25 13:07:42.329323,b4b0c56be11a184a450c74c218bbb0b9d4661816,27628,1824,24,29476
2022-06-26 13:09:19.695555,b4b0c56be11a184a450c74c218bbb0b9d4661816,27628,1824,24,29476
2022-06-27 13:16:34.055598,b4b0c56be11a184a450c74c218bbb0b9d4661816,27628,1824,24,29476
2022-06-28 13:15:46.374453,b4b0c56be11a184a450c74c218bbb0b9d4661816,27628,1824,24,29476
2022-06-29 13:15:23.382347,b4b0c56be11a184a450c74c218bbb0b9d4661816,27628,1824,24,29476
2022-06-30 13:15:30.188856,b4b0c56be11a184a450c74c218bbb0b9d4661816,27628,1824,24,29476
2022-07-01 13:15:10.375719,b4b0c56be11a184a450c74c218bbb0b9d4661816,27628,1824,24,29476
2022-07-02 13:07:33.933201,b4b0c56be11a184a450c74c218bbb0b9d4661816,27628,1824,24,29476
2022-07-03 13:07:53.233347,b4b0c56be11a184a450c74c218bbb0b9d4661816,27628,1824,24,29476
2022-07-04 13:14:30.773342,b4b0c56be11a184a450c74c218bbb0b9d4661816,27628,1824,24,29476
2022-07-05 13:16:32.758843,b4b0c56be11a184a450c74c218bbb0b9d4661816,27628,1824,24,29476
2022-07-06 13:16:51.227135,b4b0c56be11a184a450c74c218bbb0b9d4661816,27628,1824,24,29476
2022-07-07 13:19:32.312267,b4b0c56be11a184a450c74c218bbb0b9d4661816,27628,1824,24,29476
2022-07-08 13:15:04.840383,b4b0c56be11a184a450c74c218bbb0b9d4661816,27628,1824,24,29476
2022-07-09 13:08:48.112942,b4b0c56be11a184a450c74c218bbb0b9d4661816,27628,1824,24,29476
2022-07-10 13:07:56.339070,b4b0c56be11a184a450c74c218bbb0b9d4661816,27628,1824,24,29476
2022-07-11 13:21:19.347378,b4b0c56be11a184a450c74c218bbb0b9d4661816,27628,1824,24,29476
2022-07-12 13:20:20.964271,b4b0c56be11a184a450c74c218bbb0b9d4661816,27632,1824,24,29480
2022-07-13 13:18:12.146328,b4b0c56be11a184a450c74c218bbb0b9d4661816,27632,1824,24,29480
2022-09-15 13:18:24.408649,76ee775ad82ad7fb1ba2215c790d9b3651424376,27668,1824,24,29516
2022-09-16 13:16:26.952752,76ee775ad82ad7fb1ba2215c790d9b3651424376,27668,1824,24,29516
2022-09-17 13:13:04.482051,76ee775ad82ad7fb1ba2215c790d9b3651424376,27668,1824,24,29516
2022-09-18 13:13:33.245084,76ee775ad82ad7fb1ba2215c790d9b3651424376,27668,1824,24,29516
2022-09-19 13:18:33.647917,cdc3a3203f7721d17f6058979385a79cbd217551,27668,1824,24,29516
2022-09-20 13:17:45.626195,cdc3a3203f7721d17f6058979385a79cbd217551,27668,1824,24,29516
2022-09-21 13:18:41.737160,cdc3a3203f7721d17f6058979385a79cbd217551,27668,1824,24,29516
2022-09-22 13:17:14.050363,cdc3a3203f7721d17f6058979385a79cbd217551,27668,1824,24,29516
2022-09-23 13:17:02.776646,cdc3a3203f7721d17f6058979385a79cbd217551,27672,1824,24,29520
2022-09-24 13:14:21.560668,cdc3a3203f7721d17f6058979385a79cbd217551,27668,1824,24,29516
2022-09-25 13:13:47.045472,cdc3a3203f7721d17f6058979385a79cbd217551,27668,1824,24,29516
2022-09-26 13:18:40.883736,cdc3a3203f7721d17f6058979385a79cbd217551,27676,1824,24,29524
2022-09-27 13:19:46.726161,cdc3a3203f7721d17f6058979385a79cbd217551,27676,1824,24,29524
2022-09-28 13:18:28.055558,cdc3a3203f7721d17f6058979385a79cbd217551,27676,1824,24,29524
2022-09-29 13:18:40.786630,cdc3a3203f7721d17f6058979385a79cbd217551,27676,1824,24,29524
2022-09-30 13:20:13.393821,cdc3a3203f7721d17f6058979385a79cbd217551,27676,1824,24,29524
2022-10-01 13:16:41.044639,cdc3a3203f7721d17f6058979385a79cbd217551,27676,1824,24,29524
2022-10-02 13:15:01.340730,cdc3a3203f7721d17f6058979385a79cbd217551,27676,1824,24,29524
2022-10-03 13:18:42.890911,cdc3a3203f7721d17f6058979385a79cbd217551,27676,1824,24,29524
2022-10-04 13:20:28.449661,cdc3a3203f7721d17f6058979385a79cbd217551,27676,1824,24,29524
2022-10-05 13:23:30.448394,f050eec7e32a0895f7658db21a4bdbd0975087a5,27628,1824,24,29476
2022-10-06 13:19:09.103941,f050eec7e32a0895f7658db21a4bdbd0975087a5,27628,1824,24,29476
2022-10-07 13:19:19.989483,f050eec7e32a0895f7658db21a4bdbd0975087a5,27628,1824,24,29476
2022-10-08 13:15:54.781399,f050eec7e32a0895f7658db21a4bdbd0975087a5,27628,1824,24,29476
2022-10-09 13:15:03.413405,f050eec7e32a0895f7658db21a4bdbd0975087a5,27628,1824,24,29476
2022-10-10 13:20:48.573565,f050eec7e32a0895f7658db21a4bdbd0975087a5,27628,1824,24,29476
2022-10-11 13:20:21.361229,f050eec7e32a0895f7658db21a4bdbd0975087a5,27628,1824,24,29476
2022-10-12 13:18:18.468787,bea0931154d8ec38afc06a64ae1244c38a6f848f,27684,1824,24,29532
2022-10-13 13:22:03.969068,21ea0a6b388c8ec9fc8f92986748450d38337a88,27628,1824,24,29476
2022-10-14 13:20:39.752119,21ea0a6b388c8ec9fc8f92986748450d38337a88,27628,1824,24,29476
2022-10-15 13:15:31.004895,21ea0a6b388c8ec9fc8f92986748450d38337a88,27628,1824,24,29476
2022-10-16 13:15:59.437309,21ea0a6b388c8ec9fc8f92986748450d38337a88,27628,1824,24,29476
2022-10-17 13:21:27.892269,21ea0a6b388c8ec9fc8f92986748450d38337a88,27628,1824,24,29476
2022-10-18 13:21:11.277504,21ea0a6b388c8ec9fc8f92986748450d38337a88,27628,1824,24,29476
2022-10-19 13:21:13.559608,83b711876d91c069fc81383591299dcf77255004,27732,1824,24,29580
2022-10-20 13:20:50.981777,21bd77c62b75689b7ff713ace54fc3735b73dc40,27732,1824,24,29580
2022-10-21 13:21:14.063781,461def6a48e22c8eaeaef1d90a20ab56207a90df,27716,1824,24,29564
2022-10-22 13:15:56.964789,461def6a48e22c8eaeaef1d90a20ab56207a90df,27716,1824,24,29564
2022-10-23 13:15:53.037737,461def6a48e22c8eaeaef1d90a20ab56207a90df,27716,1824,24,29564
2022-10-24 13:19:54.598670,461def6a48e22c8eaeaef1d90a20ab56207a90df,27716,1824,24,29564
2022-10-25 13:21:04.918302,461def6a48e22c8eaeaef1d90a20ab56207a90df,27716,1824,24,29564
2022-10-26 13:20:18.452943,dde75de483faa8d5e42b875cef3aaf26f6c63101,27716,1824,24,29564
2022-10-27 13:17:44.199412,dde75de483faa8d5e42b875cef3aaf26f6c63101,27716,1824,24,29564
2022-10-28 13:18:17.843774,dde75de483faa8d5e42b875cef3aaf26f6c63101,27716,1824,24,29564
2022-10-29 13:11:40.038499,dde75de483faa8d5e42b875cef3aaf26f6c63101,27716,1824,24,29564
2022-10-30 13:12:37.522372,dde75de483faa8d5e42b875cef3aaf26f6c63101,27716,1824,24,29564
2022-10-31 13:17:06.828938,dde75de483faa8d5e42b875cef3aaf26f6c63101,27716,1824,24,29564
2022-11-01 13:19:38.492200,dde75de483faa8d5e42b875cef3aaf26f6c63101,27716,1824,24,29564
2022-11-02 13:18:21.895350,e9a3abaccad9f681defc742a4b455f6eab8e8d26,27716,1824,24,29564
2022-11-03 13:15:46.016498,e9a3abaccad9f681defc742a4b455f6eab8e8d26,27716,1824,24,29564
2022-11-04 13:17:19.866572,e9a3abaccad9f681defc742a4b455f6eab8e8d26,27716,1824,24,29564
2022-11-05 13:09:23.232079,e72435ce4b59c843268b33025099d818e634df3c,27716,1824,24,29564
2022-11-06 13:10:10.215665,e72435ce4b59c843268b33025099d818e634df3c,27716,1824,24,29564
2022-11-07 13:16:04.584616,e72435ce4b59c843268b33025099d818e634df3c,27716,1824,24,29564
2022-11-08 13:16:05.491384,e72435ce4b59c843268b33025099d818e634df3c,27716,1824,24,29564
2022-11-09 13:17:15.893992,e72435ce4b59c843268b33025099d818e634df3c,27716,1824,24,29564
2022-11-10 13:17:00.368484,370d7bbc85f72bdb6004a8bfb7e778c271864ee2,27716,1824,24,29564
2022-11-11 13:16:35.662545,370d7bbc85f72bdb6004a8bfb7e778c271864ee2,27716,1824,24,29564
2022-11-12 13:10:16.021309,370d7bbc85f72bdb6004a8bfb7e778c271864ee2,27716,1824,24,29564
2022-11-13 13:10:55.445369,370d7bbc85f72bdb6004a8bfb7e778c271864ee2,27716,1824,24,29564
2022-11-14 13:17:48.893052,370d7bbc85f72bdb6004a8bfb7e778c271864ee2,27716,1824,24,29564
2022-11-15 13:15:09.075905,370d7bbc85f72bdb6004a8bfb7e778c271864ee2,27716,1824,24,29564
2022-11-16 13:15:07.188479,370d7bbc85f72bdb6004a8bfb7e778c271864ee2,27716,1824,24,29564
2022-11-17 13:13:00.342564,15d75b53e1df50c45053dd585943acca7363ecc4,27732,1824,24,29580
2022-11-18 13:11:56.298607,15d75b53e1df50c45053dd585943acca7363ecc4,27732,1824,24,29580
2022-11-19 13:08:26.643799,15d75b53e1df50c45053dd585943acca7363ecc4,27732,1824,24,29580
2022-11-20 13:08:34.710358,15d75b53e1df50c45053dd585943acca7363ecc4,27732,1824,24,29580
2022-11-21 13:15:58.585468,15d75b53e1df50c45053dd585943acca7363ecc4,27732,1824,24,29580
2022-11-22 13:12:34.558486,15d75b53e1df50c45053dd585943acca7363ecc4,27732,1824,24,29580
2022-11-23 13:10:52.266046,15d75b53e1df50c45053dd585943acca7363ecc4,27724,1824,24,29572
2022-11-24 13:10:25.584884,15d75b53e1df50c45053dd585943acca7363ecc4,27724,1824,24,29572
2022-11-25 13:08:36.302300,15d75b53e1df50c45053dd585943acca7363ecc4,27724,1824,24,29572
2022-11-26 13:07:23.599864,15d75b53e1df50c45053dd585943acca7363ecc4,27724,1824,24,29572
2022-11-27 13:07:08.544568,15d75b53e1df50c45053dd585943acca7363ecc4,27724,1824,24,29572
2022-11-28 13:09:22.915316,15d75b53e1df50c45053dd585943acca7363ecc4,27724,1824,24,29572
